1 1 1 1 1 1 1 1 1 1 1 1 1 1 1 1 1 1 1 1
1 0 0 0 2 0 1 2 U 0 2 0 0 U 2 0 2 0 0 1
1 0 0 1 0 2 1 U 0 2 0 1 2 0 1 0 0 2 0 1
1 0 0 U 1 0 0 1 2 0 0 U 0 2 0 2 0 2 0 1
1 1 1 0 1 2 1 1 1 2 0 2 1 0 1 1 2 1 1 1
1 0 U 2 2 0 2 0 U 0 2 2 0 0 0 0 2 0 U 1
1 0 1 1 0 1 1 1 2 0 2 U 1 1 2 1 1 1 0 1
1 U 0 2 0 0 0 U 0 2 2 0 0 2 0 0 0 2 0 1
1 0 2 0 0 U 0 0 2 2 0 2 2 2 0 2 0 U 0 1
1 1 0 2 1 2 0 1 2 2 2 0 1 0 0 2 0 2 1 1
1 0 0 U 0 0 0 2 2 0 2 0 0 2 0 0 2 2 0 1
1 0 2 2 0 U 0 0 0 2 0 2 2 0 0 U 2 0 2 1
1 0 1 1 0 1 1 1 0 2 2 0 1 1 0 1 1 1 0 1
1 2 0 0 0 0 2 0 U 2 0 2 0 0 0 0 2 0 0 1
1 1 1 0 1 0 1 1 1 2 2 0 1 0 1 1 1 1 1 1
1 0 0 0 1 0 0 1 0 2 0 2 0 0 1 0 0 1 0 1
1 0 1 0 2 1 0 2 0 0 2 0 1 2 2 1 0 0 0 1
1 0 2 0 0 2 0 0 U 0 0 2 2 2 0 2 0 2 0 1
1 0 0 0 2 0 2 2 2 2 2 1 0 2 0 1 2 0 0 1
1 1 1 1 1 1 1 1 1 1 1 1 1 1 1 1 1 1 1 1
