1 1 1 1 1 1 1 1 1 1 1 1 1 1 1 1 1 1 1 1
1 P 0 U 2 0 1 U 2 0 0 2 1 U U 2 U 0 E 1
1 0 2 1 0 1 0 2 0 0 2 0 1 1 0 1 1 U 0 1
1 U U 0 1 U 0 1 2 0 0 2 0 0 1 U 0 1 0 1
1 1 1 0 1 0 1 1 1 2 0 2 1 0 1 1 1 1 1 1
1 0 0 U U 0 2 0 U 0 2 U 0 0 0 0 2 0 0 1
1 0 1 1 0 1 1 1 2 0 U 2 1 1 U 1 1 1 0 1
1 U 0 2 0 0 0 2 0 2 2 0 0 2 0 0 0 2 0 1
1 0 2 0 0 2 0 0 2 U 0 2 2 U 0 2 0 U 0 1
1 1 0 2 1 2 0 1 U 2 2 0 1 0 0 U 0 2 1 1
1 0 0 2 0 0 0 2 2 0 2 0 0 2 0 0 U 2 0 1
1 0 2 U 0 2 0 0 0 2 0 2 2 0 0 2 U 0 U 1
1 0 1 1 0 1 1 1 0 U 2 0 1 1 0 1 1 1 0 1
1 U 0 0 0 0 2 0 2 U 0 2 0 0 0 0 2 0 0 1
1 1 1 0 1 0 1 1 1 2 2 0 1 0 1 1 1 1 1 1
1 0 0 0 1 0 0 1 0 2 0 2 0 0 1 0 0 1 0 1
1 0 1 0 2 1 0 2 0 0 2 0 1 U 2 1 0 2 0 1
1 0 2 0 0 2 0 0 2 0 0 2 2 U 0 2 0 U 0 1
1 E 0 0 2 0 2 U 2 2 2 1 0 2 0 1 2 1 E 1
1 1 1 1 1 1 1 1 1 1 1 1 1 1 1 1 1 1 1 1